house=dom
book=książka
chair=krzesło
table=stół
window=okno
car=samochód
tree=drzewo
sun=słońce
moon=księżyc
river=rzeka
mountain=góra
flower=kwiat
road=droga
water=woda
fire=ogień
sky=niebo
star=gwiazda
forest=las
child=dziecko
friend=przyjaciel
dog=pies
cat=kot
city=miasto
country=kraj
family=rodzina
love=miłość
music=muzyka
computer=komputer
phone=telefon
food=jedzenie